0000022222222222222222222222222222222222222
0000122222222222222222222222222222222222222
1001112111000000000000000000000000000000000
1111112110000000000000000000000000000000000
0111110000000000000000000000000000000000000
0111100001000000000000000000000000000000000
0111000111000000000000000000000000000000000
1100011211000000000000000000000000000000000
1101111222222222222222222222222222222222222
1001122222222222222222222222222222222222222
1011111222222222222222222222222222222222222
0011112222222222222222222222222222222222222
0011122222222222222222222222222222222222222
0111222222222222222222222222222222222222222
0120122121212102020210202020202020202120120
2020210202102020210202102021022100210201020
2020210210202102102002102020201020020202102
2021020202021021012102111121220000000120202
1202120021021002120012002200221120020200212